Name	Sequence
MBE1A	TGTCGCTGATTTCTGAATTTTGTGTGGGG
MBE2A	TGTCGTACTGATTGATGATTTACTCTGGGG
MBE3A	CGTCCCGTAGTGTCGGTACTGATTGATGTG
MBE4A	GATGTTTAATGAACACTGATTTCTATGGGG
MBE5A	ATGGTTACTGATTTATGATTTATCTCTGGGG 
MBE6A	TGTCTGATTAATTCTGATTATTGTGTGGGG
MBE7A	TGCATGCTGATTACTGATTTTATCCTGGGG
MBE8A	TGTCGTACTGATTGATGATTTACTCGGGGG
MBE9A	GCTACTTCTGATTGATTATTTCTCTGGTGG
MBE10A	TGCTTACTACTGAAACTGATTTTTCTGGGG
MBE11A	CTGTTTACTGAACTATGATACTTTCTGGGG
MBE12A	CTGTTTACTGAACTATGATACTTTCTGGGG
MBE13A	TGCAATATAACTATGATTAAGTATACTTTGGGG
MBE14A	TGCAGACTGATTACTGACTTTCTCTAGTGG
MBE15A	GTTAAGCGGTTTAATCATTGAGATCTGGGG 
MBE17A	TGTTTGCTGATATCTGACTTTTCTCTGGGG
MBE19A	AGACTTACTGATATCTGATTCTCTAGGTGG
MBE20A	TGCATGTTGATTACTGATTTATCCTGGGG
MBE21A	GCTACTTCTGATTGATTATTTCTCTGGTGG
MBE22A	CGTCCCGTAGTGTCGGTACTGATTGATGTG
MBE23A	ATGTACTGAAATCTGAAAATTTCTATGGGG
MBE24A	TGCATCTAATGAATTCCTACTATCCTGGGG
MBE25A	TAGCTTTACTGATTGATTAATTGCTCGTGG
MBE26A	TGTCAACTGATTTATGACTGTCTCTGGTGG
MBE27A	CGTCCCGTAGTGTCGGTACTGATTGATGTG
MBE28A	CCATGATGAAAACTGATTATGACTCTGGGG
MBE29A	CGTCCCGTAGTGTCGGTACTGATTGATGTG
MBE30A	TGCTAACTGATTGATGATTTTGGGG
MBE31A	TGCTGGCTGATTTCTGAATTGTTTCTGTGG
MBE32A	TGTCTCTGATTACTGATGGTGTTTCTGTGG
MBE33A	CGTATAATGATTACTGATTCTCTAGTGTGG
MBE34A	TGCTGATTGATGATTTATGACACTATGGGG 
MBE35A	GTGCCATTACTGATTGATGATTGTTCTGGG
MBE36A	TGCAGACTGATTACTGACTTTCTCTAGTGG
MBE37A	CGTCCCGTAGTGTCGGTACTGATTGATGTG
MBE38A	ATGTCATACTGATTACTGATGACTTTGGGG
MBE39A	CTGTTTACTGAACTATGATACTTTCTGGGG
MBE40A	AATGCGGACTGATTACTGATACTCTGGGG
MBE41A	AGTAACGCTATGATGATAATGTATCCCGGGG
MBE42A	TGTCGTACTGATTGATGATTTACTCTGGGG
MBE43A	TGCAGACTGATTACTGACTTTCTCTAGTGG
MBE44A	GATGTAATATTGATCGATGAATTTGGGTGG
MBE45A	GTGCAACTTTGATCTCTTACTTTTCTGGGG
MBE46A	AATGCGGACTGATTACTGATACTCTGGGG
MBE47A	TACCACTTGTTACTGATTACTGAACTGGGG
MBE48A	TACTACTGATACTGATTTCTTGACTGGGG
MBE49A	AGTAATGCTATGATGATAATGTGTCCCGGGG
MBE50A	ATGTCATACTGATTACTGATGACTTTGGGG
MBE51A	TGTCGTACTGATTGATGATTTACTCTGGGG
MBE52A	ATTTAACTGATTTCTGACTTGTCTAGTGG
MBE53A	CGTCCCGTAGTGTCGGTACTGATTGATGTG
MBE54A	ATGTTACTGACTTCTTCTGATTTCTAGTGG
MBE55A	TGTCGCACTGACTTCTGATCTTTTCTGGGG
MBE57A	CGTCCCGTAGTGTCGGTACTGATTAATGTG
MBE59A	TGATGCAGAACTGATTGATTACTTCTGGGG
MBE62A	TGCAGAATTGGAAACTGTTATCTAGTGG
MBE63A	ATGTAGATCGATGAATACTGAGTTTTGGGG
MBE64A	ATGTTACTGACTTCTTCTGATTTCTAGTGG
MBE65A	CTGTTTACTGAACTATGATACTTTCTGGGG
MBE68A	TGTCTATGATTAATGATTGGGTCTCTGTGG
MBE70A	CAATGTCGCTACTTAAACTGATCTCCGGGG
MBE71A	CGTCCCGTAGTGTCGGTACTGATTGATGTG
MBE72A	TGTTTTGACTGATGATTTTTGTATCTGGGG
